// https://www.dcode.fr/maze-generator
@####################
....#.....#.......#.#
###.#.###.#.#.#####.#
#.#.#.#.....#.......#
#.#.#.#########.#####
#.....#.#.#...#.#.#.#
#.###.#.#.###.#.#.#.#
#...#.#.............#
#.#.###.###.#####.###
#.#.#.#.#.....#.....#
#.###.###.###.#####.#
#.....#.#.#.....#...#
#.#.#.#.#.#.#####.###
#.#.#...#.#...#.#.#.#
#.#######.#####.#.#.#
#.....#.....#...#...#
###.#########.###.###
#.......#...........#
#.###.###.###.###.###
#...#...#...#.#.....
###################.

